G_______
________
__BBBB__
__BS_B__
__BSSB__
__BBBB__
________
________
