G_______
________
__BBBB__
__B__B__
__BS_B__
__BBBB__
________
________
